آثار	اثر
آرا	رأی
آراء	رأی
آفات	آفت
آفاق	افق
آمال	امل
ائمه	امام
ابرار	بر
ابعاد	بعد
ابنیه	بنا
ابواب	باب
ابیات	بیت
اثمار	ثمر
اجرام	جرم
اجسام	جسم
اجنه	جن
احادیث	حدیث
احجام	حجم
احرار	حر
احزاب	حزب
احوال	حال
احکام	حکم
اخبار	خبر
اخلاق	خلق
اخیار	خیر
ادبا	ادیب
ادعیه	دعا
ادله	دلیل
ادوار	دور
ادویه	دوا
ادیان	دین
اذهان	ذهن
اذکار	ذکر
اراذل	رذل
اراضی	ارض
ارزاق	رزق
ارقام	رقم
ارواح	روح
ارکان	رکن
ازمنه	زمان
اساتید	استاد
اساطیر	اسطوره
اسامی	اسم
اسرار	سر
اسما	اسم
اسناد	سند
اسهال	سهل
اسیله	سوال
اشجار	شجره
اشخاص	شخص
اشرار	شر
اشراف	شریف
اشربه	شراب
اشعار	شعر
اشقیا	شقی
اشکال	شکل
اشیا	شی
اصحاب	صاحب
اصدقا	صدیق
اصناف	صنف
اصنام	صنم
اصوات	صوت
اصول	اصل
اضداد	ضد
اطبا	طبیب
اطراف	طرف
اطعمه	طعام
اطفال	طفل
اعدا	عدو
اعراب	عرب
اعزا	عزیز
اعصاب	عصب
اعضا	عضو
اعماق	عمق
اعمال	عمل
اعناب	عنب
اغذیه	غذا
اغراض	غرض
افراد	فرد
افعال	فعل
افلاک	فلک
افکار	فکر
اقالیم	اقلیم
اقربا	قریب
اقسام	قسم
اقشار	قشر
اقفال	قفل
اقلام	قلم
اقوال	قول
اقوام	قوم
الاملاح	الملح
البسه	لباس
الحام	لحم
الحکام	الحاکم
القاب	لقب
الواح	لوح
الکبار	الکبیر
اماکن	مکان
امثال	مثل
امراض	مرض
املاک	ملک
امم	امت
امواج	موج
اموال	مال
امور	امر
امیال	میل
انبیا	نبی
انجم	نجم
انظار	نظر
انفس	نفس
انهار	نهر
انواع	نوع
اهالی	اهل
اهداف	هدف
اواخر	آخرة
اواسط	وسط
اوایل	اول
اوراد	ورد
اوراق	ورق
اوزان	وزن
اوصاف	وصف
اوضاع	وضع
اوقات	وقت
اولاد	ولد
اولیا	ولی
اولیاء	ولی
اوهام	وهم
اکاذیب	اکذوبه
اکفان	کفن
ایالات	ایالت
ایام	یوم
ایتام	یتیم
بشایر	بشارت
بصایر	بصیرت
بطون	بطن
بلاد	بلد
بنادر	بندر
بیوت	بیت
تجار	تاجر
تجارب	تجربه
تدابیر	تدبیر
تعاریف	تعریف
تلامیذ	تلمیذ
تهم	تهمت
توابیت	تابوت
تواریخ	تاریخ
جبال	جبل
جداول	جدول
جدود	جد
جراثیم	جرثوم
جرایم	جریمه
جزئیات	جزء
جزایر	جزیره
جزییات	جزء
جنایات	جنایت
جهات	جهت
جوامع	جامعه
حدود	حد
حروف	حرف
حقایق	حقیقت
حقوق	حق
حوادث	حادثه
حواس	حس
حواشی	حاشیه
حوایج	حاجت
حکما	حاکم
خدمات	خدمت
خدمه	خادم
خزاین	خزینه
خصایص	خصیصه
خصوصیات	خصوصیه
خطوط	خط
خواص	خاص
دخانیات	دخانیه
دراهم	درهم
دروس	درس
دفاتر	دفتر
دلایل	دلیل
ذخایر	ذخیره
ذنوب	ذنب
ربوع	ربع
رجال	رجل
رسایل	رسال
رسوم	رسم
روابط	رابطه
روسا	رییس
ریوس	راس
زوار	زائر
ساعات	ساعت
سبل	سبیل
سطوح	سطح
سطور	سطر
سعدا	سعید
سفن	سفینه
سقاط	ساقی
سلاطین	سلطان
سلایق	سلیقه
سموم	سم
سنن	سنت
سنین	سن
سهام	سهم
سوابق	سابقه
سواحل	ساحل
سوانح	سانحه
شباب	شاب
شرایط	شرط
شروط	شرط
شرکا	شریک
شعب	شعبه
شعوب	شعب
شموس	شمس
شهدا	شهید
شهور	شهر
شواهد	شاهد
شوون	شان
شکات	شاکی
شیاطین	شیطان
صبیان	صبی
صحابه	صاحب
صحف	صحیفه
صغار	صغیر
صفوف	صف
صنادیق	صندوق
صنایع	صنیع
ضعفا	ضعیف
ضمایر	ضمیر
ضوابط	ضابطه
طرق	طریق
طلاب	طلبه
طواغیت	طاغوت
طیور	طایر
عادات	عادت
عباد	عبد
عبارات	عبارت
عجایب	عجیبه
عزایم	عزیمت
عشایر	عشیره
عطور	عطر
عظما	عظیم
عقاید	عقیده
علائم	علامت
علایم	علامت
علما	عالم
علوم	علم
عمال	عمله
عناصر	عنصر
عناوین	عنوان
عوارض	عارضه
عواطف	عاطفه
عواقب	عاقبت
عوالم	عالم
عوامل	عامل
عیوب	عیب
عیون	عین
غدد	غده
غرف	غرفه
غیوب	غیب
غیوم	غیم
فرایض	فریضه
فرق	فرقه
فضایل	فضیلت
فضلا	فاضل
فضولات	فضل
فواصل	فاصله
فواید	فایده
قبایل	قبیله
قرون	قرن
قرون	قرن
قصص	قصه
قضات	قاضی
قضایا	قضیه
قلل	قله
قلوب	قلب
قواعد	قاعده
قوانین	قانون
قیم	قیمت
قیود	قید
لذایذ	لذت
لطایف	لطیفه
لوازم	لازم
لیالی	لیل
مباحث	مبحث
مبالغ	مبلغ
متون	متن
مجالس	مجلس
محاسن	حسن
محاصیل	محصول
محافظ	محفظه
محافل	محفل
محاکم	محکمه
محصولات	محصوله
مخارج	خرج
مدارس	مدرسه
مدارک	مدرک
مداین	مدینه
مدن	مدینه
مراتب	مرتبه
مراتع	مرتع
مراجع	مرجع
مراحل	مرحله
مسائل	مسئله
مساجد	مسجد
مساعی	سعی
مسالک	مسلک
مساکین	مسکین
مسایل	مسئله
مشاعر	مشعر
مشاغل	شغل
مشاهیر	مشهور
مشایخ	شیخ
مصادر	مصدر
مصادق	مصداق
مصادیق	مصداق
مصاعب	مصعب
مصالح	مصلحت
مضار	ضرر
مضامین	مضمون
مطالب	مطلب
مظالم	ظلم
مظاهر	ظاهر
معابد	معبد
معابر	معبر
معاجم	معجم
معادن	معدن
معاذیر	عذر
معارج	معراج
معاصی	معصیت
معالم	معلم
معایب	عیب
مفاتیح	مفتاح
مفاسد	مفسده
مفاصل	مفصل
مفاهیم	مفهوم
مقابر	مقبره
مقاتل	مقتل
مقادیر	مقدار
مقاصد	مقصد
مقاطع	مقطع
مقتضیات	مقتضیه
ملائک	ملک
ملابس	ملبس
ملایک	ملکه
ملوک	ملک
ممالک	مملکت
منابع	منبع
منازل	منزل
مناسبات	مناسبت
مناسک	منسک
مناطق	منطقه
مناظر	منظره
منافع	منفعت
مواد	ماده
موارد	مورد
مواضع	موضع
مواضیع	موضوع
مواطن	موطن
مواقع	موقع
موانع	مانع
مکاتب	مکتب
مکاتیب	مکتوب
مکارم	مکرمه
میادین	میدان
نتایج	نتیجه
نعم	نعمت
نفوس	نفس
نقاط	نقطه
نواحی	ناحیه
نوافذ	نافذه
نواقص	نقص
نواقص	نقص
نوامیس	ناموس
نکات	نکته
نیات	نیت
هدایا	هدیه
واقعیات	واقعیت
وجوه	وجه
وحوش	وحش
وزرا	وزیر
وسایل	وسیله
وصایا	وصیت
وظایف	وظیفه
وعاظ	واعظ
وقایع	واقعه
کتب	کتاب
کسبه	کاسب
کفار	کافر
کواکب	کوکب
تصاویر	تصویر
صنوف	صنف
اجزا	جزء
اجزاء	جزء
ذخائر	ذخیره
خسارات	خسارت
عشاق	عاشق
تصانیف	تصنیف
دﻻیل	دلیل
عقلا	عقل
فقرا	فقر
قوا	قوه
ملل	ملت
جوایز	جایزه